#############################
#/=====\#####################
#<.....|#####################
#<.....}=================\###
#<.......................}\##
#<.....]------[..]--[.....|##
#+-----?######<..|##+[....|##
##############<..|###<....|##
##############<..|###+----?##
##############<..|###########
/============={..}==========\
<...........................|
<...........................|
<...........................|
+-----------[..]------------?
############+--?#############
** END OF MAP **
startx =    2
starty =    2
staffx =    2
staffy =    5
entranceX1 = 25
entranceY1 = 7
entranceX2 = 1
entranceY2 = 13
entranceX3 = 27
entranceY3 = 13
spawnChance = 5
spawnIncrease = 1
